6

               #####
   ####        #   ######
   #  #        # $    $ #
   #  ####     #  $##$  ###
   #     #########  # $ $ #
   #      ..........#   $ #
 ###### ##....@###  # $$  #
 #    # #####.## # ##   $ #
 #            #  #$  $$ $ #
#### #  ##### #  #  $  #  #
#    # #      #  ###   ####
#      #  #   #    #####
#   #     #####
#####     #
    #######

