

#####
# @ ####
#      #
# $ $$ #
##$##  #
#   ####
# ..  #
##..  #
 ###  #
   ####

