#####
# @ #
#...#
#$$$##
#    #
#    #
######

