

 ####
##  ###
#     #
#.**$@#
#   ###
##  #
 ####

