

#####
#   ###
#  $  #
##* . #
 #   @#
 ######

