5

 #####
 #   #
## # #####
#    ##  #######
# #     $      ####
#   #### $  $$ #  #
#####  # $$$ $ #$ #
       # $  $ $ $ ######
     ###$   #$ $  $    #
     # $ $$      ### @ ##
     #  $ $$$$####...   #
     #  $     $ #. .#...#
     ### $$$$   ......  #
       #      ##..#.....#
       ###### ##.....####
            #   .....#   #
            ##########

