       ######
       #    ###
   ##### $ $  #
####   #.#    ##
#  $ #$#.##$#####
# $$. .#.$      ##
#  $.#.#.#####  ####
##  ....... @#     #
 ####$ #.### #$###$##
  ## $  .  #  $ $ $ #
   # $ ###          #
   #   # ############
   #####

