
###########
#  .  #   #
# #.  @   #
#  #..# #######
##  ## $$ $ $ #
 ##           #
  #############

