6

      #### ###################
  #####  ###            .$   #
###  $.       #####$####   # #
#    $.  #### #     .   ### .#
#  $ $.### ## # #### #  $.# $#
###  $.## # # # #  #  # $ #  #
  ###### # ## #$ $ ##   #. # #
        ##### #.#.  #  ### # #
 #####  #   # ### ###   #    #
 ##*##  #     .#  #   #$$*  ##
 #*### ### ## ## ## #  .#. ##
 ###*# #  .$ .# $.$.## ### #
 ##*## # #.####     # $.   ##
 #*### # $$   ### ###   ##  ##
 ###*# # #   . $@$  #######. #
 ##### # ### ####.#        $ #
       #     #  ###########  #
       #######            ####

