

           #####
          ##   #
          #    #
    ####  # $ ##
    #  ####$ $#
    #     $ $ #
   ## ## $ $ $#
   #  .#  $ $ #
   #  .#      #
##### #########
#.... @  #
#....    #
##  ######
 ####

