###########
#    .##  #
# $$@..$$ #
#   ##.   #
###########

