   ####
   #  ########
#### $ $.....#
#   $   ######
#@### ###
#  $  #
# $ # #
## #  #
 #    #
 ######

