######
#    #
# #@ #
# $* #
# .* #
#    #
######

