3

   #######
  ##     ##
  #  ###  #
  # ## $  ####
  # # .#   $.####
  # # * *###.$  #
  # # *#   ### #####
  # # @ * *  # #   #
  # #  ### #*#  *  #
  # ## #  * *.# # #######
  # #  #     ....$  $   #
  # # ## $# $####$      #
###*   *     #    #######
#   ########## ####
#              #
##  ############
 ####

