0 'Particle Theory'

  # # # # # # # # # # # #
 # # # # # # # # # # # # #
#   .$    . $.  . $   .$  #
 # $# #$# # # #$# # # #  #
#  .  .    $.  .  .$ .  . #
 # #$# # # # #$#$ $# #$# #
# .     .$ .$    . $.  .  #
 # $# # # # #@# # # # #$ #
#  .  .$ .    $. $.     . #
 # #$# #$ $#$# # # # #$# #
# .  . $.  .  .$    .  .  #
 #  # # # #$# # # #$# #$ #
#  $.   $ .  .$ .    $.   #
 # # # # # # # # # # # # #
  # # # # # # # # # # # #
