9

   ####           #####
   #  #######  ####   #
   # @  $   ####   $  #
   #  ###.#    #  $$  #
 ###.## $ #$ #    #  ##
 #  ..# $ ...# ###  ##
 # $ ...$##.##     ##
 ##.###$ $..   $$ ##
  #.  #. .### $ $ #
  #  $...## ## #  #
 ## ######   #   ##
##   ##      #####
# $$  #
#   $ #
### $ #
  #  ##
  ####

