     ####
 # ###  #
 # #    #
 # #  # #
 # #$ #.#
 # #  # # #
 # #$ #.# #
   #  # # #
####$ #.# #
# @     # #
#   #  ## #
########

