

########
#      #
# $ $$ ########
##### @##. .  #
    #$  # .   #
    #   #. . ##
    #$# ## # #
    #        #
    #  ###  ##
    #  # ####
    ####

