

#######
#     #
# .$. #
# $.$ #
# .$. #
# $.$ #
#  @  #
#######

