 'from (Original 47)'

     ####
 #####  #
 #     $#######
## ## ..#  ...#
# $ $$#$  @   #
#        ###  #
#######  # ####
      ####

