 ######
##    #
#  ## #
# # $ #
#  * .#
## #@##
 #   #
 #####

