###### ####
#     #    #
#.##  #$##  #
#   #     #  #
#$  # ###  #  #
# #      #  # #
# # ####  # # #
#. @    $ * . #
###############

