

######
#    ###
#  # $ #
#  $ @ #
## ## #####
#  #......#
# $ $ $ $ #
##   ######
 #####

