

####
#  ###
#    ###
#  $*@ #
### .# #
  #    #
  ######

