

 #### ####
 #  ###  ##
 #      @ #
##..###   #
#      #  #
#...#$  # #
# ## $$ $ #
#  $    ###
####  ###
   ####

