3

   ####
  ##  #############
 ##    .......... #
##    #  ####$### ##
#      # #      #  ##
#     #  # $$$  # # #####
#####  # . .# ### . . . ##
    #   $. .#  # $$ $ $ @#
   ####### ### #   #######
   # $   $   # ## ###
   #    $  $ #  # ## # ####
   # $### ####  # # # ##  ####
   #  $ $$$  # ## #  ##      #
   ##        # ## #### $$$   #
    ## ####### .....     #####
    #  $         ######  #
    #   ######  ##    ####
    #####    ####

