1

   #####
   #   #
 ###   ########
##  ***    # # #
 #  * *    ## # #####
##  ***   ## # ##   ##
 ###   #### # # #   #
   #   # # # ####$ $###
  ##   ## # ##  $...$ ##
   ##### # ##    .@.  #
        # # #   $...$ ##
         ########$ $###
                #   #
                #####

