

#######
#     #
#@$$$ ##
#  #...#
##    ##
 ######

