2

                   #####
                   #   #
           ######### $ #
    ###### #   #   #   #
    #    # # $     $ #@#
  ### ## #### ### ## ###
  #   $  $     #   #   #
  #  $  $ # #$ # $$ $$ #
 ######  $  #  #   #   #
##    ## ###############
#  .#   $ #    #
#..    #  ######
#...####  #
#....# ####
#....#
######

