      #####
      #   ##
      # $  #
######## #@##
# .  # $ $  #
#        $# #
#...#####   #
#####   #####

