

 #######
##  .  ##
# .$$$. #
# $. .$ #
#.$ @ $.#
# $. .$ #
# .$$$. #
##  .  ##
 #######

