4

 #######
##     # #
#  *.$.#
#  *.#.###
# #$@$$  #
#   ## # #
######   #
     #####

