###########
#....#    #
#  #   $$ #
#  @  ##  #
#     ##$ #
######  $ #
     #    #
     ######

