3

   #######
 ###     ##
 #   ###  #
 #      # #
###$#@  # #
#   ##### #
#   #  *. #
##$$#  *.##
 #     *..#
 #### #...##
    # #$$$ #
    #   $  #
    #####  #
        ####

