   ####
   #@ #
  ##  #
  # .$#
  #$. #
###..$###
#  ..$  #
# $ $ # #
##### # #
    #   #
    #####

