 #####
 #   #
##   ##
# $$$ #
# .+. #
#######

