              #####
              #   #
    #####     #   #######
    #   ##### #   ..... #
##### # ##  # #     # # #
# $ $ $ $ $ # ##   ## $ #
# # ##......#### ### $$ ###
#      ## * #    # #  $$  #
##########+$$   ## #      #
         #.$ $# #  ########
         #.##   #
         ########

