9

####
#  #              ####
#  ######## #######  #
#         ###  ##  $ #
##.###### ...     #. #
 #.#      # .#   # $ #
 #$$$$#$$$ #.#   ##. #
 #.# $   $ #..      ##
 #.#  $  $   # #   ##
 #  #   $$ #   #####
 #.  ##$  ######
 #.   #  $.  #
##. @ ###.#$ #
#     # #    #
#    ## ######
######

