   ##########
####    ##  #
#  $$$....$@#
#      ###  #
#   #### ####
#####

