########
#  ... #
#  ### ##
#  # $  #
## #@$  #
 # # $  #
 # ### #####
 #         #
 #   ###   #
 ##### #####

