

  ####
 ##  #####
 #  $  @ #
 #  $#   #
#### #####
#  #   #
#    $ #
# ..#  #
#  .####
#  ##
####

