      ########
 ######      ##########
## $     ###          ##
# $ $ ## #  #########  #
#  $  #              # #
# $ $ # #  ######### # #
#  $  #  # #. . . .  # #
# $ $ # #    . . . .## #
#  $  # # # . . . . #  #
##$ $## #  #### # #   ##
 #   #@ #       #  ####
 ######  #####  #  #
      ##     #  #  #
       #####  ##  ##
           ##    ##
            ######

