

#####
#   ###
#. .  #
#   # #
## #  #
 #@$$ #
 #    #
 #  ###
 ####

