7

    ###########
   ## . . . . ###
   #  $$ $ $ $  #
   #   ######## # #####
 #### ##  $     # #   #
 #    #  $ $ #  ### # #
##  # #   ####     $  #
#...  ##### $  #### ###
#... @     $     #    #
#...############ $  $ #
#####          #####  #
                   ####

