

#####
#   ###
# .   ##
##*#$  #
# .# $ #
# @## ##
#     #
#######

