

 ####
 #  ######
##    $  #
# .# $   #
# .#$#####
# .@ #
######

