######## #####
#  #   ###   #
#      ## $  #
#.# @ ## $  ##
#.#   # $  ##
#.#    $  ##
#. ## #####
##    #
 ######

