            #####
            # ..########
            # ......#  #
            #.. ##$$  $#
         #####.##   $  #
         #  ....# $  $$#
##### ## #  .. .#$  $  #
#   #    # ##.###  $$ $###
#   ###  # ## #  $  #    #
# @   #### #  # # ###$ # #
#             #  $    $  #
#   ####      ### ####$$##
#  ##  ####     #       #
#  #      ##    ######  #
####       ##     # # $ #
            ##    # #   #
             ###### #####

