####
# @###
#.*  #####
#..#$$ $ #
##       #
 # # ##  #
 #   #####
 #####

