

 #####
##   #
#    #####
#  #.#   #
#@ #.# $ #
#  #.#  ##
#    #  #
##  ##$$#
 ##     #
  #  ####
  ####

