####
#  ######
#       ####
# $ $   #  #####
##### ###    $ #
 #  #   $  #   #
 #      ##$######
 # $###  # ...# #
 ## #@#$ ##.#.# #
 #    #   #...# #
 # $ ##$ $#...#####
 ### ##   #...    #
  #  #  $ $ $ # # #
  # $### ###### # #
  #             # #
  #############   #
              #####

