     ####
     # @#
     #  #
###### .#
#   $  .#
#  $$# .#
#    ####
###  #
  ####

