0

     ####
     #  #
######$.#
#   $ $.#
# $@$...#
# $$$..##
#  $ ..#
########

