     #######
######     ######
#  . ..$#$.. .  #
#  $ $  .  $ $  #
###$####@####$###
#  $ $  .  $ $  #
#  . ..$#$.. .  #
######     ######
     #######

