

  ####
###  #
#    ###
# # . .#
# @ ...####
# # # #   ##
#   # $$   #
#####  $ $ #
    ##$ # ##
     #    #
     ######

