

   ####
   #  #
   #@ #
####$.#
#   $.#
# # $.#
#    ##
######

