5

         #####
     #####  #####
     #  .#$   $ #
     # #. $$$ @ ##
     #  .#$   $  #
     ###.#  $ $  #
       #.  ##$ ###
 #######*###.$ #
 # $    ....####
## #$#$$....#
#  $ $   #..#
#     $  #..#
#  ##########
#####

