       #########
       ###    ##  ####
#####  #    * ##  #  #
#   #### ****  ####$.##
# .$      *@*      $. #
##.$####  **** ####   #
 #  #  ## *    #  #####
 ####  ##    ###
       #########

