

 ####
 #  ###
 # $$ #
##... #
#  @$ #
#   ###
#####

