4

 #############
##       #   ###
#  $ $$$$$     #
### $   $  ### #
  # $ $ $### # #
  ##   $ ##  # ###
   ####   ####   #
     ###       # ###
   ####   ####     #
   #@ $   ###  #.# #####
   # $ $ ## #  ....    #
   # $$ ##  ####.....  #
  ## $  #     #..#.##  #
  # $ $ ##    #......  #
  #  $ $ #    # . ..# ##
  ##  $  #    ## ##.# #
   #    ##     #      #
   ######      ########

