       #####
########   #
#.   .  @#.#
#  ###     #
## $  #    #
 # $   #####
 # $#  #
 ## #  #
  #   ##
  #####

