#####
#   #######
#  $      ##
## ######  ##
 # #    # # ########
 # # ##    $       ##
 # #.   #@###### $  ##
 # #.#  ###    ## $  ##
 # #.    #      ## $  ##
 # #.#   #  ##   ## $  ##
## #.#  ##  ###   ## $  #
#  #.#   #  #*##   ##   #
#   .# # #  ##*##   #####
######   #  ######
     #####

