#######
#  *  #
#     #
## # ##
 #$@.#
 #   #
 #####

