####
#  ####
# . . #
# $$#@#
##    #
 ######

